VVVVVVVVVVVVVVVVVVVVV
VVVVVVVVVVVVVVVVVVVVV
VVVVVVVVVVVVVVVVVVVVV
VVVVVVVVVMVVVVVVVVVVV
VVVVVVVVVVVVVVVVVVVVV
222222222222222222222
666666666666666666666